0000000000
1122222200
1211111120
1111111110
1111111110
1211111120
1222222220
1333300000